{
    "7": [0, 0],
    "8": [1, 0],
    "9": [2, 0],
    "4": [0, 1],
    "5": [1, 1],
    "6": [2, 1],
    "1": [0, 2],
    "2": [1, 2],
    "3": [2, 2]
}